Tim	Alsop
Carol	Davidson
Claire	Ince
Jan	Edmunds
Lucas	Wilkins
Maria	Peake
Phil	Piper
Jack	Welch
Luke	Thomson
Adam	Bailey
Victor	Langdon
Natalie	Walker
Melanie	Kerr
Leah	Mitchell
Angela	Gill
Julia	Hughes
Joshua	McGrath
Robert	Arnold
Neil	Hodges
Una	Mills
Theresa	Watson
Kevin	Springer
Vanessa	Berry
Carol	Butler
Edward	North
James	Hudson
Angela	Payne
Christian	Greene
Isaac	Wilson
Joanne	Peake